25 25
0000010000000010000000000
0000010000000010000000000
0000010000000010011111111
0000010000000000000000000
0000010000000000000000000
0011111111111110000011111
0000010000000000000000000
0000010000000000000000000
0000010000000000000000000
0011110001110000001111111
0000000000010000000000000
0000000000010000000000000
0000000000010000000000000
0000000000011110000111111
0000000000010000000000000
1110011111110000000000000
0000000100000000000000000
0000000100000001111110000
0000000100000000001000000
1111111111100000001000000
0000000000100000001000000
0000000000100000001000000
0000000000100000001111111
0000000000100000000000000
0000000000100000000000000